
54 0 0 0 0 65 0 0 0 0 0 0 0 0 0 70 0 0 0 
0 0 19 19 0 0 0 0 0 0 0 0 0 0 0 0 0 4 0 
0 0 19 19 0 0 0 0 34 34 0 0 0 0 0 0 0 0 0 
0 0 0 0 0 0 0 0 0 0 0 0 0 0 0 0 0 0 0 
0 0 0 0 0 0 0 0 0 0 0 0 0 0 0 0 0 0 0 
64 0 0 0 0 29 0 29 0 0 0 0 0 0 44 44 0 0 0 
69 0 0 0 0 29 0 29 0 0 0 0 0 0 44 44 0 0 0 
0 0 0 0 0 29 0 29 0 0 0 0 0 0 0 0 0 0 0 
0 0 0 0 0 29 0 29 0 0 0 0 0 0 0 0 0 0 0 
70 0 0 0 0 0 0 0 0 0 0 0 0 0 0 0 0 0 24 
0 0 0 0 0 0 0 0 0 0 0 0 0 0 65 0 0 0 24 
0 0 0 0 0 0 0 0 0 0 0 0 0 0 0 0 0 0 24 
0 9 0 0 0 0 0 0 0 0 0 0 0 0 0 0 0 0 24 
0 0 24 24 24 0 0 49 0 0 24 24 24 0 0 24 24 24 24 
2 0